----######
###-######
###-######
###@@@##*#
###@%@####
###@-@####
####-#####
###---####
##########
##########